0	water_tile.bmp
1	village_tile.bmp
2	desert_tile.bmp
3	grasslands_tile.bmp
4	forest_tile.bmp
5	camp1.bmp
6	safe_tile.bmp
7	bridge_tile.bmp

{0,0,0,0,0, 0,1,0,0,0}
{0,6,2,3,7, 3,3,0,0,0}
{0,2,2,2,0, 0,0,3,0,0}
{0,3,2,2,2, 3,3,3,3,0}
{0,3,2,2,2, 2,3,3,3,0}
{0,3,0,2,0, 0,2,2,3,0}
{0,3,3,0,3, 3,0,2,3,0}
{0,0,0,0,4, 3,3,0,3,0}
{5,4,4,4,4, 3,3,3,3,0}
{0,0,0,0,0, 0,0,0,0,0}

